111111111111
10001P010001
100100001001
1010C0000101
1100000C0011
100C00000001
11000000C011
10100C000101
100100001001
10001E010001
111111111111